trastorno - zamet, niepokoj
aumentar - rosnac
recalcar - podkreslac
restringir - ograniczac
ligado a - zwiazany z
enfatizar - podkreslac
comportamiento - zachowanie
agravar - nasilac
agudo - zaostrzony
soler - miec w zwyczaju
sencillo - easy
maletender - misunderstand
quejarse - complain
hacer dano - zaszkodzic
a proposito - on purpose
ocultar - hide
ligero - light
llama - fire, flame
suceder - to happen
escoger - choose
eligir - choose
acordar - agree
pegar - beat
aburrido - boring
pesado - heavy, annoying
esconder - hide
listo - smart
manejar - drive
enojado - angry
valer la pena - be worth of
despacio, lento - slowly
regalo - gift
rechazar - refuze
alegrarse - to be happy
abrigado - sheltered, protected, warm
direcion - adres
avergonzado - ashamed
cometer un error - make an error
no me lo puedo creer - i cant believe it
escritorio - desk
malgastar - waste
gastar - spend
consejo - advice
aviso - notice, warning
ingenuo - naive
pretender - to intend
a ciencia cierta - for certain
excepto - except, but
cuarto - room
enfermera - nurse
tan pronto como - as soon as
deberia haber ... - I should have ...
tiembre - bell